1111111111111111111
1000000000C00000001
1000000000000000001
100P000000000000001
10000C0C0C0C0000001
10000C0C0C0C0000001
10000C0C0C0C0000001
10000C0C0C0C0000001
10000C0C000C0000011
10000C0C0C0C0000001
10000C0C0C0C00000E1
1111111111111111111