11111
1PCE1
11111
11101
11111
11111