1111111111111111111111111111111111
1010000000000000000000000000000001
11010000000000000000000000C0000001
10C0000000000000000000000000000001
10000C0000000000000000000000000001
1000000000000000000000000000000001
1000000000000000000000000000000001
1000000000000000000000000000000001
10000000PC000000000000000000000001
1000000000000000000000000000000001
1000000000000000000000000000000001
1000000000000000000000000000000001
1000000000000000000C00000000000001
1000000000000000000000000000000001
1000000000000000000000000000000001
10000000000000000000000000000C0001
1000000000000000000000000000000001
1000000C00000000000000000000000E01
1000000000000000000000000000000001
1111111111111111111111111111111111